46 41
# . . . . . . . # . . . . . . . . . . . . . . . . . # . . . . . . . . . . . . . # . . . . . . . . .
# . # # # # # # # . # # # # # # # . # # # # # # # . # # # . # # # # # # # . # # # . # # # # # # # .
# . . . . . # . . . # . # . . . # . . . # . . . . . . . . . # . . . . . . . # . . . # . . . # . . .
# # # # # . # . # # # . # . # . # # # . # # # . # # # # # # # # # # # # # # # . # # # # # . # . # .
# . . . . . # . # . # . . . # . . . # . . . # . . . # . . . . . . . . . . . . . # . . . . . # . # .
# . # # # # # . # . # . # # # . # # # # # . # # # . # . # # # # # # # # # # # # # . # # # . # . # #
# . . . # . . . # . # . . . # . . . . . # . # . . . # . # . . . . . . . # . . . . . # . . . # . . .
# # # . # . # # # . # # # . # # # # # . # . # . # # # . # . # # # # # . # . # # # # # # # # # # # .
# . . . # . . . # . . . . . . . . . # . # . # . . . # . . . # . # . . . # . . . . . # . . . . . . .
# . # # # # # . # # # # # # # # # # # . # . # # # . # # # # # . # . # # # . # # # . # . # # # # # #
# . . . . . # . . . . . . . . . . . # . # . . . # . . . # . . . # . . . # . . . # . # . # . . . . .
# . # # # . # # # # # # # # # # # . # . # # # . # # # # # . # . # # # . # # # # # . # . # . # # # .
# . # . # . . . . . . . # . . . . . . . # . . . # . . . . . # . . . # . # . . . . . # . . . . . # .
# . # . # # # # # . # # # . # # # # # # # . # . # . # # # # # . # . # . # . # # # # # # # . # # # .
# . . . # . . . # . . . . . # . # . . . . . # . # . . . . . # . # . # . . . # . . . . . # . # . . .
# # # . # . # . # # # # # # # . # . # # # # # # # # # # # . # . # # # # # . # . # # # . # # # . # .
# . # . # . # . . . # . . . . . # . # . . . . . . . . . # . # . . . . . . . # . # . # . . . # . # .
# . # . # . # # # # # . # . # # # . # . # # # # # . # # # . # # # # # . # # # . # . # # # . # . # #
# . # . # . . . . . # . # . . . # . . . # . . . # . . . . . # . . . # . # . . . . . # . . . # . . .
# . # . # # # # # . # . # # # . # # # # # . # # # # # # # # # . # . # # # . # # # # # . # # # # # .
# . . . # . . . . . # . # . # . . . . . # . . . . . . . . . # . # . # . . . # . . . . . # . . . . .
# . # # # . # # # # # . # . # . # # # . # # # . # # # . # # # . # . # . # # # . # # # # # . # # # .
# . # . . . . . . . . . . . # . # . . . . . # . # . . . # . . . # . . . # . # . # . . . . . # . # .
# . # # # # # # # . # # # # # . # # # # # . # # # . # . # . # # # # # # # . # . # # # # # . # . # .
# . . . . . . . # . # . . . # . . . . . # . # . . . # . # . . . # . . . . . # . . . # . . . # . . .
# # # # # # # . # # # . # . # # # # # . # . # . # # # . # # # . # # # . # . # # # . # . # # # # # .
# . . . . . # . . . # . # . . . . . . . # . . . # . . . . . # . . . . . # . # . # . # . . . . . # .
# . # # # # # # # . # . # # # # # # # # # . # # # # # # # # # # # # # # # . # . # . # # # . # . # .
# . # . . . . . . . # . # . . . # . . . . . # . . . . . . . . . . . . . # . . . # . . . # . # . # .
# . # . # # # # # # # . # . # . # # # # # # # . # # # # # # # # # . # # # # # . # # # . # . # . # .
# . # . # . . . . . . . # . # . . . . . . . # . # . . . . . . . # . . . . . # . # . # . # . # . # .
# . # . # . # # # # # . # . # # # # # # # . # . # . # # # # # # # # # # # . # . # . # . # # # . # #
# . # . # . . . . . # . # . . . # . . . # . . . # . . . # . . . . . . . # . . . . . # . . . # . . .
# . # . # . # # # . # # # # # . # . # . # # # # # # # . # . # # # . # # # # # # # # # # # . # # # .
# . # . # . . . # . . . . . # . . . # . . . . . . . # . . . # . # . . . # . . . . . . . # . . . # .
# . # . # . # # # # # . # # # # # # # # # # # # # . # . # # # . # # # . # . # # # # # . # # # . # .
# . . . # . # . . . # . . . . . . . # . . . . . # . # . # . . . . . # . # . . . . . # . # . . . # .
# . # # # # # . # . # # # # # . # . # . # . # # # . # . # . # # # . # . # # # # # . # . # . # # # .
# . . . . . . . # . . . . . # . # . . . # . . . # . # . . . # . . . # . . . . . # . # . . . # . . .
# # # # # # # # # # # # # . # . # # # # # # # . # . # # # # # # # # # . # . # # # . # # # # # # # .
# . . . . . . . . . . . # . # . # . . . . . # . # . # . . . . . . . # . # . . . # . . . # . . . . .
# . # # # # # # # # # # # . # # # . # # # . # . # . # . # # # # # . # # # # # . # # # . # # # . # .
# . . . . . . . . . . . . . # . . . # . # . . . # . . . # . . . # . . . . . # . . . # . . . # . # .
# . # # # # # # # # # # # # # . # # # . # # # . # # # # # . # # # # # # # . # . # . # # # . # . # .
# . . . # . . . . . . . . . . . # . . . # . # . # . . . . . . . . . # . # . # . # . . . # . # . # .
# # # . # # # # # # # . # # # # # . # . # . # . # # # # # . # . # . # . # . # . # # # # # . # . # #
# . # . # . . . . . # . . . . . # . # . . . # . . . . . # . # . # . . . # . # . # . . . . . # . . .
# . # . # . # # # . # # # # # . # . # # # # # # # # # . # # # . # # # . # . # . # # # # # # # # # .
# . . . . . # . . . . . . . . . # . . . . . . . . . . . . . . . # . . . # . . . . . . . . . . . . .
# # # # # # # # # # # # # # # # # # # # # # # # # # # # # # # # # # # # # # # # # # # # # # # # # #
